MAP	HF	NJ	SZ	SH	WH	HS	HZ	NC	WZ
HF	0	2	0	0	9	6	0	0	0
NJ	0	0	1	0	0	3	0	0	0
SZ	0	0	0	6	0	1	0	0	0
SH	0	0	0	0	0	0	0	0	5
WH	0	0	0	0	0	0	0	4	0
HS	0	0	0	0	2	0	9	7	0
HZ	0	0	0	5	0	0	0	0	1
NC	0	0	0	0	0	0	1	0	5
WZ	0	0	0	0	0	0	0	0	0

